11111111111111111
1001000C000CM0001
10C001111100C0011
1P0011E00C0010C11
11111111111111111