11111111111111111
1001000C000C00001
100011E00C0000001
11111110011000001
1001000C000C00001
10C00111100000001
1P0011E00C0000001
11111111111111111