11111111
1000E001
10P000C1
11111111